44444444
41321514
41113124
41111114
42111214
41111314
41121114
44444444